#####  B#
##### ##
##### #
####  ##
#### ##
     ##
A######     